NO ./path_to_the_north_texture
SO ./path_to_the_south_texture
WE ./path_to_the_west_texture
EA ./path_to_the_east_texture

F 200,1,0  
C 200,1,0111

111111111111111111111111
100000000000010000000001
1000000000W0100000000001
1000000000000000000000011111
1000000000000011110000000001
1000000000000000000000011111
1000000000000000000000011111111
1000000000011111110000000000001
11111111111       1111111111111