NO textures/hh.png
SO textures/kk.png
WE textures/why.png
EA textures/ss.png

F 200,1,1
C 200,1,0111

111111111111111111111111
100000000000010000000001
1000000000S100000000001
100000000000000000000001111
1000000000000011110000000111
1000000000000000000000010011
1000000000000000000000000000111
1000000000011111110000000011
111111111111111111111111111111 