NO ./path_to_the_north_texture
SO ./path_to_the_south_texture
WE ./path_to_the_west_texture
EA ./path_to_the_east_texture
     
F 200,1,0    
C 200,1,01111  

111111111111111111111111
100000000000000000000001
100000000000000000000001
100000000000000000000001
100000111111110000000001
1000001      10000000001
1111101      11111111111
    1001111
111110000001
10000000001
10000000001
11111111111