NO ./path_to_the_north_texture
SO ./path_to_the_south_texture
WE ./path_to_the_west_texture
EA ./path_to_the_east_texture

F 200,1,0  
C 200,1,0111

111111111111111111111111
100000000000010000000001
1000000000N0100000000001
100000000000000011111111
111111111111000111111111
111111111000000000000001111111111111111111
        110000000000000000000000000000000111
        111101111111111111111110000001111111
        111110000000000000000000000000000001
        1000000000000000000011111111111111011
        100000000000000000000000000000000001
        111111111111111111111111111111111111