SO textures/mm.png
WE textures/d.png
EA textures/kk.png
 
F 200,1,1
NO textures/why.png
C 200,1,0




1111111111111111111111111111111
11111111111111111111111
1000000000000100000000011
10000000000001000000000111
10000000000001000000S00111
100000000001111111000000011
10000000000001000000000111
10000000000001000000000111
10000000000001000000000111
10000000000001000000000111
10000000000001000000000111
10000000000001000000000111
10000000000001000000000111
10000000000001000000000111
10000000000001000000000111
10000000000001000000000111
10000000000001000000000111
10000000000001000000000111
10000000000001000000000111
10000000000001000000000111
10000000000001000000000111
10000000000001000000000111
10000000000001000000000111
10000000000001000000000111
10000000000001000000000111
10000000000001000000000111
10000000000001000000000111
10000000000001000000000111
10000000000001000000000111
10000000000001000000000111
10000000000001000000000111
10000000000001000000000111
10000000000001000000000111
10000000000001000000000111
10000000000001000000000111
10000000000001000000000111
10000000000001000000000111
10000000000001000000000111
10000000000001000000000111
10000000000001000000000111
10000000000001000000000111
10000000000001000000000111
10000000000001000000000111
10000000000001000000000111
10000000000001000000000111
10000000000001000000000111
10000000000001000000000111
10000000000001000000000111
10000000000001000000000111
10000000000001000000000111
10000000000001000000000111
10000000000001000000000111
10000000000001000000000111
10000000000001000000000111
10000000000001000000000111
10000000000001000000000111
10000000000001000000000111
10000000000001000000000111
10000000000001000000000111
10000000000001000000000111
10000000000001000000000111
10000000000001000000000111
10000000000001000000000111
10000000000001000000000111
10000000000001000000000111
10000000000001000000000111
10000000000001000000000111
10000000000001000000000111
10000000000001000000000111
10000000000001000000000111
10000000000001000000000111
10000000000001000000000111
10000000000001000000000111
10000000000001000000000111
10000000000001000000000111
10000000000001000000000111
10000000000001000000000111
10000000000001000000000111
10000000000001000000000111
10000000000001000000000111
10000000000001000000000111
10000000000001000000000111
10000000000001000000000111
10000000000001000000000111
10000000000001000000000111
10000000000001000000000111
10000000000001000000000111
10000000000001000000000111
10000000000001000000000111
10000000000001000000000111
10000000000001000000000111
10000000000001000000000111
10000000000001000000000111
10000000000001000000000111
10000000000001000000000111
11111111111111111111111111