SO textures/mm.png
WE textures/d.png
EA textures/kk.png
 
F 200,1,1
NO textures/why.png
C 200,1,0




1111111111111111111111111111111
10000000000100000000001
100000000000000000000001111
1000000000000011110000000111
1000000000100000000000010011
100000000000000000000000000111
1000000N0001111111000000011
10000000000001000000000111
11111111111111111111111111