SO textures/wall.png
NO textures/wall.png
WE textures/wall.png
EA textures/wall.png

C 100,20,5
F 14,8,9

1111111111111111111111111111111111111111111111111111111111111111111111111111111111111111111111111111111111111111111111111111111111111111111111111111
1000000000000000000000000000000000000000000000000000000000000000000000000000000000000000000000000000000000000000000000000000000000000000000000000001
1000000000000000000000000000000000000000000000000000000000000000000000000000000000000000000000000000000000000000000000000000000000000000000000000001
1000000000000000000000000111111111111111111111111111111111111111111111111111111111111111111111111111111111111111111111111111111111111111111100000001
10000000000000000000000001                                                                                                                  100000001
10000000000000000000000001                                                                                                                  100000001
10000000000000000000000001                           11111111111111111111111111111111111                                                    100000001
10000000000000000000000001                           10000000000000000000000000000000001                                                    100000001
10000000000000000000000001                           10000000000000000000000000000000001                                                    100000001
10000000000000000000000001                           10000000000000000000000000000000001                                                    100000001
11111100000111111100001111                           10000000000000000000000000000000001                                                    100000001
    100000000000000000000011111111111111111111111111100000000000000000000000000000000001                                         11111111111111010111
    10000000000N000000000000000000000000000000000000000000000000000000000000000000000001                                         100000000000000000001                                          
    100000000000000000000000000000000000000000000000000000000000000000000000000000000001                               1111111111110000000000000000001
    100000000000000000000011111111111111111111111111100000000000000000000000000000000001                               1000000000000000000000000000001
    10000000000000000000001                         100000000000000000000000000000000001                               1000000000000000000000000000001
    10000000000000000000001                         100000000000000000000000000000000001                               1111111111100000000000000000001
    10000000000000000000001                         10000000000000000000000000000000000111111111111111111111111111111111111111111100000000000000000001
    11111111100000111111111                         10000000000000000000000000000000000000000000000000000000000000000000000000000000000000000000000001
            1000001                                 10000000000000000000000000000000000000000000000000000000000000000000000000000000000000000000000001
            1000001                                 11111111111111111111111111111111111111111111111111111111111111110001111111111111111111111000111111
11111111111110000011111111111111111111111111111                                                                    10001                    10001
10000000000000000000000000000000000000000000001                                                                    10001                    10001
10000000000000000000000000000000000000000111111                  11111111111111111111111111111111111111111111111111100011111111111111111111110001111111
10000000000000000000000000000000000000000000001                  10000000000000000000000000000000000000000000000000000000000000000000000000000000000001
1000000000000000000000000000000000000000000000111111111111111111110000000000000000000000000000000000000000000000000000000000000000000000000000000000001
1000000000000000000000000000000000000000000000000000000000000000000000000000000000000000000000000000000000111111111111111111111111111111111110001111111
10000000000000000000000000000000000000000000000000000000000000000000000000000000000000000000000000000000001                                 10001
10000000000000000000000000000000000000000000001111111111111111111100000000000000000000000000000000000000001                                 10001
10000000000000000000000000000000000000000000001                  100000000000000000000000000000000000000001                                 10001
10000000000000000000000000000000000000000000001                  111111111111111111111111111111111111111111                                 10001
11111111111111111111111111111111111111111111111                                                                                             11111