SO textures/wall1.png
NO textures/2.png
WE textures/d.png
EA textures/wall.png

C 204,225,245
F 238,238,238

111111111111111111111111111
100000000000000000000000001
100000000000000000000000001
100000000000000000000000011
1W000000011111111110000000011
100000000000000000000000011
10000000001111111111000000011
100000000000000000000000011
100000000000000000000000011
100000000000000000000000011
111111000001111111000011111
111111111111111111111111111
                                