
SO textur es/wall.png
WE textur es/2.png
NO textur es/wall.png
 
EA textur es/wall.png
F 200,156,89
C 166,207,245


1111111111111111111111111111111
11111111111111111111111
1000000000000100000000011
10000000000001000000000111
10000000000001000000S00111
100000000001111111000000011
111000111000000100000000011
111110000001000001111000111
     1111111000000000111111
      111111100000001100011
        1111100000000001001
11111111110001100001111111
 11100000000000000000001
   100000000000000000011
    1100000000000000011
      100000000000001
       11111000000111
       11111111111111


